af|Afrikaans
sq|Albanian
ar|Arabic
hy|Armenian
eu|Basque
be|Belarusian
bg|Bulgarian
ca|Catalan
zh|Chinese
hr|Croatian
cs|Czech
da|Danish
nl|Dutch
en|English
et|Estonian
fo|Faroese
fi|Finnish
fr|French
de|German
el|Greek
he|Hebrew
hi|Hindi
hu|Hungarian
is|Icelandic
id|Indonesian
it|Italian
ja|Japanese
ko|Korean
lv|Latvian
lt|Lithuanian
mk|Macedonian
ms|Malay
mr|Marathi
nb|Norwegian (Bokm+?l)
nn|Norwegian (Nynorsk)
fa|Persian
pl|Polish
pt|Portuguese
ro|Romanian
ru|Russian
sa|Sanskrit
sk|Slovak
sl|Slovenian
es|Spanish
sw|Swahili
sv|Swedish
ta|Tamil
tt|Tatar
th|Thai
tr|Turkish
uk|Ukrainian
ur|Urdu
vi|Vietnamese
